111111111111111111111111111111111111
100000000000000000000000000000000001
100000000000000000000000000000000001
100000000000010000000000000000000001
1000000000000C1000000000000000000001
10C0000000000100000000000P0000000001
100000000000000000000000000000000001
100000000000000000000000000000000001
100000000000000000000000000000000001
1000000000000000000000000E0000000001
111111111111111111111111111111111111