1111111111111
10001000000P1
1001010111001
1001010101011
1001010001001
1001011111C01
10E0000000001
1111111111111
