11111111111111111111111111111111111111111
100000000000000C00000C0000000000000000001
10100101001000001010010000000000000010101
11100100101010100010010000000000000010111
1P0000000C00C00000000000000000000000E00C1
11111111111111111111111111111111111111111
