111111111111111111111111111
1C0000000000000000000000001
1C0000000000000000000000001
1C0000000000000000000000001
1C0000000000010000000000001
1C00000000001E1000000000001
1C0000000000000000000000001
100000000000000000000000001
1P0000000000000000000000001
111111111111111111111111111