11111111111111111111111111111111111111111111111111111111111111111
1C100000000000000000000000000000000000000000000000000000000000001
1C100000000000000000000000000000000000000000000000000000000000001
1C100000000000000000000000000000000000000000000000000000000000001
1C100000000000000000000000000000000000000000000000000000000000001
1C100000000000000000000000000000000000000000000000000000000000001
1C100000000000000000000000000000000000000000000000000000000000001
1C100000000000000000000000000000000000000000000000000000000000001
1C100000000000000000000000000000000000000000000000000000000000001
100000000000000000000000000000000000000000000000000000000E0000001
1P100000000000000000000000000000000000000000000000000000000000001
11111111111111111111111111111111111111111111111111111111111111111