11111111111111111111111111111111111111111111
100011111111111111111111000000000000000E0001
10001111111111111111111100000000000000000001
100011111111111111111111000000C0000000000001
10000000000000000000000000000000000000000001
1000000P000000000000001111111111111111111111
100000000000000000C0001111111111111111111111
11111111111111111111111111111111111111111111
11111111111111111111111111111111111111111111
100011111111111111111111000000000000000E0001
10001111111111111111111100000000000000000001
100011111111111111111111000000C0000000000001
10000000000000000000000000000000000000000001
1000000P000000000000001111111111111111111111
100000000000000000C0001111111111111111111111
11111111111111111111111111111111111111111111